%%%%%%%%%%%%%%%%%%%
%                P%
% %%%%%%%%%%%%%   %
%          %%%  % %
%%%%%%%%%% %%  %  %
%          %  %  %%
% %%%%%%%%%  %    %
%      %%%  %  %%%%
%%%%%% %%  %      %
%      %  %  %%%%%%
% %%%%%  %        %
%  %%%  %  %%%%%%%%
%% %%  %          %
%  %  %  %%%%%%%%%%
% %  %            %
%  %%  %%%%%%%%%%%%
%.                %
%%%%%%%%%%%%%%%%%%%
