%%%%%%%%%%%%%%%%%%%%%%%%%%%%%%%%%%%%%%%
%                                    P%
% % % % % % % % % % % % % % % % % % % %
% % % % % % % % % % % % % % % % % % % %
% % % % % % % % % % % % % % % % % % % %
% % % % % % % % % % % % % % % % % % % %
% % % % % % % % % % % % % % % % % % % %
% % % % % % % % % % % % % % % % % % % %
% % % % % % % % % % % % % % % % % % % %
% % % % % % % % % % % % % % % % % % % %
% % % % % % % % % % % % % % % % % % % %
% % % % % % % % % % % % % % % % % % % %
% % % % % % % % % % % % % % % % % % % %
%.% % % % % % % % % % % % % % % % % % %
%%%%%%%%%%%%%%%%%%%%%%%%%%%%%%%%%%%%%%%
