%%%%%%%%%%%%%%%%%%%%%%%%%%%%%%%%%%%%%%%
%%                %                  P%
% %              % %              % %%%
%  %            %                %    %
%   %          %     %          %     %
%    %        %       %        %      %
%     %      %         %      %       %
%      %    %           %    %        %
%       %  %             %  %         %
%                         %%          %
%       % %               % %         %
%      %   %             %   %        %
%     %     %                 %       %
%    %       %         %       %      %
%   %         %       %               %
%  %           %     %           %    %
% %             %   %             %   %
%%                 %               % %%
%.                %                  %%
%%%%%%%%%%%%%%%%%%%%%%%%%%%%%%%%%%%%%%%
