%%%%%%%%%%%%%%%%%%%
%           %     %
% % %%%%%%%%% %%% %
% %           %%% %
% % %%%%%%%%%%% % %
% % %%%       % % %
% % %   %%%%%%% % %
% %   %         % %
% %% %%%%%%%%%% % %
%     %         %.%
% % %%%%%%%%%%% %%%
% % %  %      % % %
% % % %% %%%%%% % %
% % %         % % %
% %   %% %%%%%% % %
% %%%%%% %      % %
% %%%%%% % %%%%%% %
%       P         %
%%%%%%%%%%%%%%%%%%%
