%%%%%%%%%%%%%%%%%%%%%%%%%%%%%%%%%%%%%%%
% %   %   %   %   %   %   %   %   %  P%
% % % % % % % % % % % % % % % % % % % %
% % % % % % % % % % % % % % % % % % % %
% % % % % % % % % % % % % % % % % % % %
% % % % % % % % % % % % % % % % % % % %
% % % % % % % % % % % % % % % % % % % %
% % % % % % % % % % % % % % % % % % % %
% % % % % % % % % % % % % % % % % % % %
% % % % % % % % % % % % % % % % % % % %
% % % % % % % % % % % % % % % % % % % %
% % % % % % % % % % % % % % % % % % % %
% % % % % % % % % % % % % % % % % % % %
% % % % % % % % % % % % % % % % % % % %
% % % % % % % % % % % % % % % % % % % %
% % % % % % % % % % % % % % % % % % % %
% % % % % % % % % % % % % % % % % % % %
% % % % % % % % % % % % % % % % % % % %
%   %   %   %   %   %   %   %   %   % %
% %%%%%%%%%%%%%%%%%%%%%%%%%%%%%%%%%%% %
%                %.%                  %
% %%%%%%%%%%%%%%%% %%%%%%%%%%%%%%%%%% %
%                %     %%%%%     %%%% %
% %%%%%%%%%%%%%% % %%%    %% %%% %% % %
% %              % % % %%%%%%       % %
% % %%%%%%%%%%%%%% % % %    %%%% %%%% %
% %              % %   % %% %%%    %% %
% %%%%%%%%%%%%%%%% % %%%%   %   %%%%% %
%                  %      %   %       %
%%%%%%%%%%%%%%%%%%%%%%%%%%%%%%%%%%%%%%%
